17,27
Z11111222222333300000000000
211112233334444320000000000
322223444455554432100000000
433334555566665443210000000
544444555555544333210000000
555555544444433223211100000
544443322233322112332111000
433332111123222121232111100
332211011112332121122111100
222110000112332112111111100
11110000001233221121111111X
011000000001233322111100000
000000000001222332211000000
000000000000111123210000000
000000000000000011110000000
000000000000000000000000000
000000000000000000000000000