10,9
Z00000000
111111111
222222222
333333333
444444444
555555555
666666666
777777777
888888888
99999999X